I                                                          L
C                   a                                      E
C                  aM                                      E
C                 aM                         a             E
C                aM                         aaa            E
C               aM          aaa            aaaaa           E
C         a    aM          aLBIa          aaaaaaa          E
C         Ma   M    a    aaLGAFIaa       aaaaaaaaa         E
C          Ma      aM   LBBGAAAFBBI    LBBBBBBBBBBBI       E
C           Ma    aM    KDDDDDDDDDJ    KDDDDDDDDDDDJ       E
C       3    M   aM                                        E
C        3      aM                                         E
C       3       M                                          E
C       3                                                  E
C 3 3 3 3 M          M    0 2  0    1   0     1    1 2     E
FBBBBBBBBBBBBBBBBBBBBBBBBBBBBBBBBBBBBBBBBBBBBBBBBBBBBBBBBBBG
AAAAAAAAAAAAAAAAAAAAAAAAAAAAAAAAAAAAAAAAAAAAAAAAAAAAAAAAAAAA