I                                                                                                    L
A                   a                                                                                E
A                  aA                                                                                E
A                 aA                        a                                                        E
A                aA                        aaa                                           d           E
A               aA          aaa           aaaaa                                         aaa          E
A         a    aA          aAAa          aaaaaaa                b                     aaaaaa         E
A         Aa   A    a     aAAAAaa       aaaaaaaaa                                   AAAAAAAAAa       E
A          Aa      aA    AAAAAAAAa     AAAAAAAAAAAa        aaaa   aaaa            aA         Aa      E
A           Aa    aA    AAAAAAAAAA    AAAAAAAAAAAAA     AAAAAAAAAAAAAAAAA        aA           Aa     E
A            Aa  aA           3          3                                      aA             Aa    E
A   b           aA                              AAAAAA                         aA     AAAAAA         E
A               A                                  3              b            A         3           E
A                                       c                                                            E
A  1 1  A          A     1          aaaaaaaaa        1                           1                   E
KMMMMMMMMMMMMMMMMMMMMMMMMMMMMMMMMMMMMMMMMMMMMMMMMMMMMMMMMMMMMMMMMMMMMMMMMMMMMMMMMMMMMMMMMMMMMMMMMMMMMK
KKKKKKKKKKKKKKKKKKKKKKKKKKKKKKKKKKKKKKKKKKKKKKKKKKKKKKKKKKKKKKKKKKKKKKKKKKKKKKKKKKKKKKKKKKKKKKKKKKKKKK