I                                                               a                                     L
C                                                              aaa                                    E
C                                                            aLBBBIa                                  E
C                                                          aaLGAAAFIaa                                E
C                                                     a   LBBGAAAAAFBBI                               E
C                                            b       aM   KDDDDDDDDDDDJ                               E
C                            c                      aM                                                E
C                                      M     2     MM                                                 E
C                          aLBIa       LBBBBBBBBBBBI                                         4        E
C                       $ aLGAFIa#     KDDDDDDDDDDDJ                                                  E
C                       LBBGAAAFBBI                                          c                        E
C               aaaa    KDDDDDDDDDJ               aaaaa     b      aaaaa                              E
C                                            a                               a         LBI        LBI E
C                    M     aaaaaaa          aMa                             aM                        E
C%@ !!   @  %@ !! @ MM  !  2    !!   @2  %  MMM   !$  #  0!!  @ 0   @  !!   MM                        E
FBBBBBBBBBBBBBBBBBBBBBBBBBBBBBBBBBBBBBBBBBBBBBBBBBBBBBBBBBBBBBBBBBBBBBBBBBBBBBBBBBBBBBBBBBBBBBBBBBBBBBG
AAAAAAAAAAAAAAAAAAAAAAAAAAAAAAAAAAAAAAAAAAAAAAAAAAAAAAAAAAAAAAAAAAAAAAAAAAAAAAAAAAAAAAAAAAAAAAAAAAAAAAA