I                                                                                                     L
C                   a                                          d                                      E
C                  aM                                        aLBIa                                    E
C                 aM                                       aaLGAFIaa                                  E
C                aM          a               b        a   LBBGAAAFBBI                                 E
C               aM          aaa                      aM   KDDDDDDDDDJ                                 E
C   c     a    aM          aLBIa                    aM                                                E
C  MMM    Ma   M    a   !@aLGAFIaa     M     2     MM                                                 E
C          Ma      aM   LBBGAAAFBBI    LBBBBBBBBBBBI                                           4      E
C           Ma    aM    KDDDDDDDDDJ    KDDDDDDDDDDDJ                                                  E
C            M   aM                                                                                   E
C               aM                                                                                    E
C               M                a           a               b                           LBI      LBI E
C                               aaa         aMa                                                       E
C%@ !!           !  @M $# % 2  aaaaa  2     MMM    aaa   0      2   aaa                               E
FBBBBBBBBBBBBBBBBBBBBBBBBBBBBBBBBBBBBBBBBBBBBBBBBBBBBBBBBBBBBBBBBBBBBBBBBBBBBBBBBBBBBBBBBBBBBBBBBBBBBBG
AAAAAAAAAAAAAAAAAAAAAAAAAAAAAAAAAAAAAAAAAAAAAAAAAAAAAAAAAAAAAAAAAAAAAAAAAAAAAAAAAAAAAAAAAAAAAAAAAAAAAAA