I                                                                                                    L
A                   a                                                                                E
A                  aA                                                                                E
A                 aA                        a                                                        E
A                aA                        aaa                                           d           E
A               aA          aaa           aaaaa                                         aaa          E
A         a    aA          aAAa          aaaaaaa                                      aaaaaa         E
A         Aa   A    a     aAAAAaa       aaaaaaaaa                                   AAAAAAAAAa       E
A          Aa      aA    AAAAAAAAa     AAAAAAAAAAAa        aaaaaaaa               aA         Aa      E
A           Aa    aA    AAAAAAAAAA    AAAAAAAAAAAAA     AAAAAAAAAAAAAAAAA        aA           Aa     E
A            Aa  aA                                                             aA             Aa    E
A               aA                                   A                         aA                    E
A               A                     3                                        A           3         E
A                                             3                           3                          E
A  1 1  A          A     1                           1       3                   1                   E
KMMMMMMMMMMMMMMMMMMMMMMMMMMMMMMMMMMMMMMMMMMMMMMMMMMMMMMMMMMMMMMMMMMMMMMMMMMMMMMMMMMMMMMMMMMMMMMMMMMMMG
KKKKKKKKKKKKKKKKKKKKKKKKKKKKKKKKKKKKKKKKKKKKKKKKKKKKKKKKKKKKKKKKKKKKKKKKKKKKKKKKKKKKKKKKKKKKKKKKKKKKKK