I                                                                                                     L
C                                                               d                                     E
C                                                            aLBBIa                                   E
C                                                          aaLGAAFIaa                                 E
C                                                     a   LBBGAAAAFBBI                                E
C                                            b       aM   KDDDDDDDDDDJ                                E
C                            c                      aM                                                E
C                           aaa        M     2     MM                                                 E
C                          aLBIa       LBBBBBBBBBBBI                                           4      E
C                       $ aLGAFIa#     KDDDDDDDDDDDJ                                                  E
C                       LBBGAAAFBBI                                                                   E
C               aaaa    KDDDDDDDDDJ               aaaaa     b      aaaaa                              E
C                                            a                               a         LBI        LBI E
C                    M     aaaaaaa          aMa                             aM                        E
C%@ !!   @  %@ !! @ MM  !  2    !!   @2  %  MMM   !$  #  0!!  @ 0   @  !!   MM                        E
FBBBBBBBBBBBBBBBBBBBBBBBBBBBBBBBBBBBBBBBBBBBBBBBBBBBBBBBBBBBBBBBBBBBBBBBBBBBBBBBBBBBBBBBBBBBBBBBBBBBBBG
AAAAAAAAAAAAAAAAAAAAAAAAAAAAAAAAAAAAAAAAAAAAAAAAAAAAAAAAAAAAAAAAAAAAAAAAAAAAAAAAAAAAAAAAAAAAAAAAAAAAAAA